15,5
0,0,0,0,0,0,0,0,4,5,5,5,5,5,5
0,1,0,1,0,0,0,1,1,4,4,5,5,5,5
0,0,0,0,0,1,0,0,0,0,4,4,4,4,5
1,0,0,0,1,0,0,1,0,1,1,0,0,1,4
0,0,0,0,0,0,0,0,0,0,0,1,0,0,0
LINKS 3
LINK 14,3 test.map
LINK 8,0 test2.map
LINK 0,4 test4.map
