10,5
0,1,0,0,0,1,1,0,0,0
0,0,1,0,0,2,0,0,1,0
0,2,0,0,0,1,0,0,1,0
0,2,1,1,0,0,1,0,0,0
0,0,0,0,0,0,1,0,0,0
LINKS 1
LINK 0,4 test2.map
