15,5
0,0,0,0,0,1,1,0,0,0,0,0,0,0,0
2,2,2,2,0,1,0,0,1,0,0,0,1,0,0
2,3,3,3,0,1,0,0,1,0,1,0,0,0,0
2,2,2,2,0,0,1,0,0,0,0,1,0,0,0
0,0,0,0,0,0,1,0,0,0,0,1,1,0,0
LINKS 2
LINK 3,2 test.map
LINK 0,4 test3.map
